获得	aqtj
函数	biov
阵列	blgq
感知	dgtd
封装	ffuf
元组	fqxe
运算符	fttw
列表	gqge
睿智	hptd
源码	iddc
图谱	ltyu
赋值	mfwf
内置	mwlf
魔法	osif
字段	pbwd
字符串	ptkk
键值	qvwf
排序	rhoc
气魄	rnrr
执着	rvug
迭代	rwwa
矩阵	tdbl
重构	tgsq
关键字	uqpb
递归	uxjv
分块	wvfn
分片	wvth
维度	xwoa
计数	yfov
遍历	ynde
交集	ywwy
